%%%%%%%%%%%%%%%%%%%%%%%%%%%%%%
%       % % %              % %
%       % % %%%%%% %%%%%%% % %
%       %        %     % %   %
%%%%% %%%%% %%% %% %%%%% % %%%
%   % % % %   %    %     %   %
% %%% % % % %%%%%%%% %%% %%% %
%.      %     %%     % % %  .%
%%% % %%%%%%% %%%% %%% % % % %
% %           %%     %     % %
% % %%%%% % %%%% % %%% %%% % %
%   %     %      % %   % %%% %
%   %P%%%%%      % %%% %     %
%%%%%%%%%%%%%%%%%%%%%%%%%%%%%%