%%%%%%%%
%      %
%.  P .%
% %%%% %
% %    %
% % %%%%
% %    %
%%%%%%%%
